Policy_ID,Premium,Claim_Amount,Claim_Auto_Processed,is_sustainable,design_score,sentiment_score,goal_alignment_score,revenue
0,43249,18864,1,1,0.6181578013990711,0.5635551740882947,0.7272376584957886,24385
1,29849,8363,1,1,0.9351914336867378,0.9086563712583916,0.9479492683150432,21486
2,39697,6957,1,1,0.8225144658788272,0.529182559453568,0.7838990084441316,32740
3,13773,5210,1,1,0.9059718213000896,0.6019154358652052,0.8359624190550982,8563
4,42092,16776,1,1,0.8574240169233242,0.5163662487466629,0.7912634218899957,25316
5,35076,18359,1,1,0.7688389885544956,0.4963451909698672,0.7550613931747877,16717
6,10587,19069,1,1,0.641580178908884,0.938682293632344,0.8600874908470759,-8482
7,39124,3083,0,0,0.71364468187513,0.7814162010868843,0.4983536276540047,36041
8,21787,19070,0,0,0.9289563332862578,0.7210440138550815,0.5500001157137798,2717
9,26448,5158,1,1,0.9085437781656382,0.6015134554979618,0.8366857445545334,21290
10,11499,17571,1,1,0.708040001989631,0.8361417716570152,0.8480605912155488,-6072
11,9841,3782,1,1,0.4881695713797821,0.576366634094882,0.6881787351582215,6059
12,31402,5100,1,1,0.7487310265694881,0.8190458941495153,0.8559256402396679,26302
13,29055,12701,1,1,0.7412297111870884,0.5691233085091545,0.770117673232081,16354
14,45827,16525,1,1,0.7450227387959617,0.6033238447186492,0.7827821945048704,29302
15,6665,19456,1,1,0.8228539201831402,0.8137423579176881,0.8788654260336095,-12791
16,38271,1097,1,1,0.8576212579321664,0.829574101623365,0.8957317865185104,37174
17,29237,10483,1,1,0.8690299547099525,0.7896209400845141,0.8862169649314889,18754
18,48988,4464,1,1,0.8145709140135368,0.5425488826364807,0.7857065988833392,44524
19,34267,2787,1,1,0.5899229298077364,0.6329909701415757,0.7409712999831041,31480
20,16774,8763,1,1,0.7358800267306704,0.7235348111797769,0.8198049459701492,8011
21,6553,1683,1,1,1.0,0.5726078557134862,0.8575359519044955,4870
22,19860,17092,1,1,0.8074216734802478,0.905644414019394,0.9043553624998806,2768
23,30903,2132,1,1,0.8067819568443866,0.3397079584074181,0.7154966384172683,28771
24,13045,13314,0,0,0.8059485939773858,0.583189072694627,0.463045888890671,-269
25,15380,6877,0,0,0.811537962250599,0.6235650245695252,0.4783676622733748,8503
26,38917,14068,1,1,0.5316887818914077,0.2734084502842348,0.6016990773918808,24849
27,38261,15633,1,1,0.7460475683088932,0.4905656304645713,0.7455377329244882,22628
28,19343,16758,1,1,0.7662107168205311,0.7937934268813103,0.8533347145672804,2585
29,8853,18425,1,1,0.8981495399253413,0.7045425454829445,0.8675640284694287,-9572
30,16128,12057,1,1,0.7747672894622296,0.9359704033064352,0.9035792309228882,4071
31,8736,1854,0,0,0.6053488613398059,0.9317839668827228,0.5123776094075095,6882
32,39724,6738,1,1,0.8130089156171753,0.764956956790592,0.8593219574692558,32986
33,17440,3026,1,1,0.6896175351757254,0.7469857373501066,0.812201090841944,14414
34,11180,6365,0,0,0.6483214358918582,0.709889666286835,0.4527370340595644,4815
35,36284,3550,1,1,0.686584095328342,0.3017376973180765,0.6627739308821395,32734
36,47375,8089,1,1,0.8242504229664516,0.4908160730010886,0.77168883198918,39286
37,17646,17623,1,1,0.8958761239760069,0.7151013254648401,0.8703258164802823,23
38,25029,17873,1,1,0.8182929945177587,0.7924038563121507,0.8702322836099698,7156
39,26158,13043,1,1,0.8332023223617022,0.7434504718207211,0.8588842647274744,13115
40,20342,2036,1,1,0.8173045272838001,0.5661302548426513,0.7944782607088171,18306
41,43781,7122,1,1,0.7801327176860469,0.8406109423704243,0.8735812200188238,36659
42,6084,15578,0,0,0.8396930634962758,0.9223666043131954,0.587353222603157,-9494
43,7935,16689,1,1,0.528122453293058,0.840698440043701,0.7896069644455862,-8754
44,36466,17150,0,0,0.7811088351304833,0.8484398994385706,0.5431829115230179,19316
45,48376,12692,1,1,0.6655074965377749,0.6161161303067183,0.7605412089481643,35684
46,15262,13054,0,0,0.886290257254414,0.8613901184051198,0.5825601252198446,2208
47,17604,2767,1,1,0.755284469478314,0.7218637958991485,0.8257160884591542,14837
48,48481,5708,1,1,0.773094808826783,0.7767333292783006,0.8499427127016945,42773
49,29133,9353,1,1,0.6194928125746196,0.7548147764237063,0.791435862999442,19780
50,34667,2256,1,1,0.8716830889012852,0.6817769341839383,0.8511533410284078,32411
51,41241,11143,1,1,0.8327328120273809,0.5709996287316547,0.8012441469196786,30098
52,39503,6351,1,1,0.8256947882340503,0.687679500466893,0.8377914295669812,33152
53,8838,15263,0,0,0.6886977147831178,0.8480142426224233,0.5122373191351803,-6425
54,41330,1749,1,1,0.692636015506187,0.6337786292030635,0.7754715482364168,39581
55,19440,18092,1,1,0.7923599454445905,0.8340020893912219,0.8754540116119375,1348
56,42674,7416,1,1,0.7005501589751949,0.8105606005926507,0.8370369198559485,35258
57,40040,7950,1,1,0.8134892962677339,0.6551593904470254,0.8228828955715866,32090
58,43604,13328,0,0,0.5539087397233278,0.9083200155429364,0.4874095850887547,30276
59,40630,2713,1,1,0.7212455443593407,0.6466679993213941,0.789304514560245,37917
60,42994,13777,1,1,0.9496753465426492,0.9264320293918946,0.958702458644848,29217
61,32339,9308,0,0,0.8139485827995765,0.7651190472311459,0.5263558766769075,23031
62,36384,11673,1,1,0.7866793664530993,0.697620112231973,0.8280998262283573,24711
63,47782,16378,1,1,0.9685226535671356,0.5668297929493519,0.8451174821721624,31404
64,38643,16329,1,1,0.5364046381198564,0.6867609654797437,0.7410552011998668,22314
65,22926,14882,0,0,0.6884688885211893,0.669436072975837,0.4526349871656754,8044
66,44977,17579,1,1,0.7298826828252611,0.5112555422123641,0.7470460750125417,27398
67,29652,5714,1,1,0.855835123300539,0.6673576865923498,0.8410642699642962,23938
68,16270,11664,1,1,0.8575656363228237,0.5794295229854372,0.8123317197694203,4606
69,23268,16753,1,1,0.6833993291017374,0.7878987653468172,0.8237660314828515,6515
70,42417,13321,1,1,0.8697954322142549,0.8959420713592304,0.9219125011911616,29096
71,26317,15630,0,0,0.7296685232678293,0.5159626485557138,0.4152103906078477,10687
72,42434,18658,1,1,0.8911639625649167,0.9568461592550384,0.9493367072733184,23776
73,21448,4709,1,1,0.6667357301877942,0.6807173448422305,0.7824843583433415,16739
74,15913,1338,0,0,0.757668840093384,0.5537467922592229,0.4371385441175356,14575
75,14566,7761,1,1,0.720983268462344,0.8136632170312275,0.8448821618311904,6805
76,38444,5275,1,1,0.8756030371565714,0.6330318282617428,0.8362116218061048,33169
77,21605,12491,1,1,0.717721878343383,0.6877394985952758,0.8018204589795529,9114
78,6557,19040,1,1,0.7657551470988244,0.6393582633681881,0.8017044701556708,-12483
79,48240,7762,1,1,0.820681139766305,0.577489310220265,0.7993901499955234,40478
80,12040,9834,1,1,0.824525848302612,0.8085995548602856,0.8777084677209658,2206
81,39896,15358,1,1,0.8586952607473172,0.6570547895658718,0.8385833501043963,24538
82,27804,10872,0,0,0.7911124776844667,0.4845022311731131,0.4252049029525266,16932
83,15292,18553,1,1,0.7281751084720169,0.7826590186323898,0.8369447090348023,-3261
84,32110,9173,0,0,0.7350301254641249,0.5191626473464367,0.4180642576035205,22937
85,11349,17685,1,1,0.7725672315207612,0.5270109740987111,0.7665260685398242,-6336
86,36374,12333,1,1,0.7949592476074383,0.8788909307465973,0.8912833927846785,24041
87,25009,18950,1,1,0.7552828352151564,0.5205490151184682,0.7586106167778749,6059
88,48591,12356,1,1,0.7719203420965547,0.3525332714608764,0.7081512045191437,36235
89,6057,8816,0,0,0.6182746139427895,0.7934292227442243,0.4705679455623379,-2759
90,14503,13149,1,1,0.8367355284454678,0.6544204855778304,0.830385338007766,1354
91,34293,19594,1,1,0.788111228888943,0.6673517318292825,0.8184876535727419,14699
92,48961,12344,1,1,0.8701870413541088,0.6528249409974699,0.8410039941171928,36617
93,25121,17187,1,1,0.7700160507407086,0.734750490852809,0.8349221805311725,7934
94,11493,12851,1,1,0.5961602421478214,0.5870921137145397,0.7277507852874537,-1358
95,42645,8230,0,0,0.7341553810693325,0.9214172311848646,0.5518575374180658,34415
96,8282,9803,1,1,0.7500070076881583,0.4785654279535902,0.7428574785472494,-1521
97,29170,16795,0,0,0.8442903305433599,0.7667312375015685,0.5370071893483095,12375
98,7431,2943,0,0,0.5629726455486606,0.7963181505814876,0.4530969320433827,4488
99,40543,15015,1,1,0.7741179516948935,0.5860522358749933,0.786723395856629,25528
100,26591,9348,1,1,0.8213675215793306,0.5464398332083272,0.7892691182625526,17243
101,17351,12750,1,1,0.703851211471848,0.8525761321255234,0.8521424478657904,4601
102,38483,6385,1,1,0.7774628009816847,0.5513708868974927,0.7762778959597258,32098
103,37195,17639,1,1,0.7072963490850156,0.6090004088874149,0.7720989193241435,19556
104,43153,10243,1,1,0.697042706677961,0.8330963443689618,0.8433796836823076,32910
105,28735,17273,1,1,0.7291580149868683,0.7052111850308536,0.8114564000059072,11462
106,21203,6032,1,1,0.6989308007532989,0.4304284498556343,0.7097864168696444,15171
107,9974,7261,1,1,0.8383618311936333,0.9620588716830272,0.9334735676255534,2713
108,44673,19801,1,1,0.6965048123164622,0.6204983861830051,0.7723343994998224,24872
109,43233,19640,1,1,0.6797089992952072,0.6395864065140373,0.7730984686030814,23593
110,25686,3634,0,0,0.9467928666839532,0.7383676378489548,0.561720168177636,22052
111,45713,2891,1,1,0.8660740011824035,0.7937615195506109,0.886611840244338,42822
112,49826,11683,1,1,0.58384866393408,0.99416564369372,0.8593381025425999,38143
113,18636,10967,1,1,0.6935231710147467,0.4509897775891455,0.7148376495346307,7669
114,41070,13128,0,0,0.7942462971722711,0.8238928313388918,0.5393797095037209,27942
115,35123,8426,0,0,0.8023755067231494,0.8114514541075115,0.5379423202768869,26697
116,37812,2970,1,1,0.6209507134263107,0.6794252633688824,0.7667919922650643,34842
117,34760,7771,1,1,0.8858565492822322,0.8180910542224333,0.9013158678348884,26989
118,10966,11684,1,1,0.8525224419181626,0.8401411026454819,0.8975545148545482,-718
119,24426,13857,1,1,0.8181901632040339,0.4927055822519492,0.7702985818186611,10569
120,20162,18032,0,0,0.905672849071212,0.9624649758821244,0.6227126083177789,2130
121,22058,10832,1,1,0.8152289992570918,0.4661856620292787,0.7604715537621235,11226
122,47482,15640,1,1,0.8148580879251848,0.529702557814184,0.7815202152464562,31842
123,49667,13626,1,1,0.9257679271822242,0.6607318489563855,0.8621665920462033,36041
124,8998,19485,1,1,0.8801219580727709,0.9887410769780584,0.9562876783502764,-10487
125,6909,14423,1,1,0.6858492541088469,0.653761505536992,0.7798702532152797,-7514
126,40648,17802,1,1,0.8333195178671915,0.6952099164923784,0.8428431447865233,22846
127,18497,17333,1,1,0.7035732135041418,0.9148117905856844,0.8727950013632754,1164
128,24944,3352,1,1,0.8204154550950278,0.654952278615179,0.8251225779034023,21592
129,13527,2751,0,0,0.8176613507019814,0.5232344930603986,0.4469652812541267,10776
130,44464,13167,1,1,0.6316532687544014,0.6374147747142528,0.7563560144895515,31297
131,9072,6524,1,1,0.7578154388688965,0.9056187750708664,0.8878114046465876,2548
132,18018,19735,1,1,0.7965257023580402,0.7106297495582704,0.8357184839721036,-1717
133,35652,16183,0,0,0.7263709809005843,0.9895987388584389,0.5719899065863411,19469
134,10476,18673,1,1,0.801470994239076,0.8106902389393232,0.8707204110594664,-8197
135,49835,12315,1,1,0.8505897777001069,0.6032786595409775,0.817956145747028,37520
136,36232,3702,0,0,0.7669406935769244,0.7076614456697617,0.491534046415562,32530
137,33482,9835,1,1,0.792459947670826,0.5720172822787181,0.788159076649848,23647
138,43257,15542,1,1,0.9083424078555976,0.5997350454026844,0.8360258177527605,27715
139,26875,13259,1,1,0.8173196583225226,1.0,0.9391065527741742,13616
140,22219,3922,1,1,0.7900824289674474,0.8527936765050717,0.880958701824173,18297
141,36448,7654,1,1,0.6741920620358639,0.8291646983510009,0.8344522534622882,28794
142,20367,3021,0,0,0.8371026011388849,0.6065229527037903,0.4812085179475584,17346
143,31120,14955,1,1,0.8030149949391938,0.9354376099421616,0.9128175349604518,16165
144,12855,16716,1,1,0.8983739433701409,0.8649123402689405,0.9210954278796938,-3861
145,9097,12310,1,1,0.7746878543303312,0.9822431934036656,0.9189770159113322,-3213
146,25889,17520,0,0,0.5883733499866004,0.9749671222597672,0.5211134907487892,8369
147,7084,5225,0,0,0.5999879131171738,0.4781366067853717,0.3593748399675152,1859
148,39320,10209,1,1,0.8435680763759733,0.5335240766095138,0.7923640509951624,29111
149,27944,12892,1,1,0.7129806402301847,0.5494318276804545,0.7541374893035465,15052
150,39921,16723,1,1,0.8136767751110497,0.5584089035001344,0.790695226203728,23198
151,27857,13719,1,1,0.7814232644502356,0.7485178546390585,0.843313706363098,14138
152,24070,4140,0,0,0.7533160332306079,0.6149794821856274,0.4560985051387451,19930
153,30475,12721,1,1,0.7603638714411777,1.0,0.9201212904803926,17754
154,28219,3587,0,0,0.6834610494954774,0.9857019823122456,0.556387677269241,24632
155,47457,11574,1,1,0.7684222311100329,0.699030760888144,0.8224843306660591,35883
156,37489,7669,1,1,0.7115506567205602,0.9932989324224684,0.9016165297143428,29820
157,29178,19989,1,1,0.7327743479874296,0.9232201940860304,0.8853315140244865,9189
158,19483,6004,1,1,0.7376350955290839,0.6323940161234112,0.790009703884165,13479
159,39573,15301,1,1,0.7473306730101281,0.3986176983961657,0.715316123802098,24272
160,39688,9400,1,1,0.8622173456507086,0.6673047422558905,0.8431740293021998,30288
161,37529,8504,0,0,0.7570209170795307,0.603306680338229,0.4534425324725865,29025
162,40211,4810,1,1,0.8723702336590099,0.7309758437718745,0.8677820258102948,35401
163,45816,7080,1,1,0.9237854951326482,0.7133842430312123,0.8790565793879536,38736
164,39978,8408,1,1,0.855494465105615,0.7094526488348842,0.8549823713134997,31570
165,35677,5153,0,0,0.8234468535068511,0.7785527112068746,0.5339998549045752,30524
166,22004,12055,1,1,0.8026832209483521,0.5181217079374482,0.7736016429619333,9949
167,16272,18752,1,1,0.856535870905007,0.7617040416354561,0.8727466375134877,-2480
168,12212,4800,0,0,0.7789360738596239,0.634057577047449,0.4709978836356909,7412
169,27071,2037,1,1,0.8684569845957198,0.729997329979553,0.8661514381917576,25034
170,49108,1992,1,1,0.8314105805289684,0.8436114767848284,0.8916740191045989,47116
171,15700,5510,0,0,0.7340159539219613,0.5163400340168455,0.4167853293129355,10190
172,35980,1393,1,1,0.8595850880102807,0.6578059520995645,0.8391303467032817,34587
173,23297,9005,1,1,0.7791480005977569,0.6822198648956703,0.8204559551644758,14292
174,47349,17741,0,0,0.7593867992387684,0.6228596542644038,0.4607488178343907,29608
175,34625,18565,1,1,0.7223800839601013,0.8349744244199435,0.8524515027933482,16060
176,34831,7817,1,1,0.7866018847874573,0.5919417461799292,0.7928478769891288,27014
177,35367,3065,1,1,0.8696462615412983,0.6166899400836492,0.8287787338749825,32302
178,41338,13094,1,1,0.8588940005593038,0.5935121300571903,0.8174687102054979,28244
179,26121,14879,1,1,0.8053393797458956,0.8638083117158202,0.8897158971539053,11242
180,41547,12610,1,1,0.8299643640725035,0.6261333831381675,0.8186992490702236,28937
181,30914,1154,1,1,0.8971696791522559,0.7690068086325333,0.888725495928263,29760
182,23178,10746,1,1,0.7550033708829139,0.9963557651845112,0.9171197120224752,12432
183,7722,9678,0,0,0.6584579996469794,0.6887772369474121,0.4490784121981305,-1956
184,19885,7294,1,1,0.9001129852178573,0.8668091020049735,0.9223073624076102,12591
185,6102,10574,1,1,0.7170221747969282,0.9507031126139692,0.8892417624702991,-4472
186,33435,3415,1,1,0.7009661876656096,0.854078734006062,0.8516816405572238,30020
187,19262,16979,1,1,0.5903802244665448,0.6974798026033389,0.7626200090232945,2283
188,13453,2070,1,1,0.8271283053164297,0.796316163849792,0.8744814897220738,11383
189,48407,19638,1,1,0.6078547375447778,0.5068932110296982,0.7049159828581587,28769
190,18224,15785,1,1,0.6949741192308263,0.5829935262775072,0.7593225485027778,2439
191,12172,17306,1,1,0.8288236794515059,0.6092987227552121,0.8127074674022393,-5134
192,17252,11067,1,1,0.8421921252408372,1.0,0.947397375080279,6185
193,23918,8807,1,1,0.7048295851781766,0.5781123228617099,0.7609806360132955,15111
194,13197,19574,1,1,0.7565846673007595,0.5758784873107256,0.7774877182038283,-6377
195,37591,8398,1,1,0.6827405473593847,0.5434118529626524,0.7420508001073457,29193
196,19677,13202,1,1,0.7151603212188817,0.7839717642896141,0.8330440285028319,6475
197,17039,3972,1,1,0.7966215260152907,0.7213932089003324,0.8393382449718744,13067
198,33785,18898,1,1,0.7198353321203542,0.8630138465539847,0.8609497262247796,14887
199,10570,12312,0,0,0.7455784959824331,0.8006889499116031,0.5154224819646788,-1742
200,12706,14627,0,0,0.6235293318382433,0.4929415229913898,0.3721569516098777,-1921
201,17655,2345,1,1,0.8832956164806138,0.5789083344984444,0.8207346503263527,15310
202,39202,19301,1,1,0.8210066593171066,0.9047993122413732,0.9086019905194932,19901
203,15449,8641,0,0,0.8492905371837202,0.6695052633134793,0.5062652668323998,6808
204,30630,16099,1,1,0.8990425324616862,0.8781387727027019,0.9257271017214628,14531
205,15122,14385,1,1,0.6874787124454284,0.6775478578127024,0.7883421900860436,737
206,16991,9644,1,1,0.7341605516971976,0.5548515357567217,0.7630040291513064,7347
207,30887,2611,1,1,0.5805165632417789,0.6545108833499941,0.7450091488639243,28276
208,19859,19462,1,1,1.0,0.5547925306675455,0.8515975102225152,397
209,29640,11773,1,1,0.7550414684682624,0.6151670856396364,0.7900695180359661,17867
210,31532,19448,1,1,0.8738727899914912,0.7301388559847869,0.8680038819920927,12084
211,45229,6779,1,1,0.6461838855664541,0.776740763555353,0.807641549707269,38450
212,44764,10450,0,0,0.8696388425643009,0.4614713015118552,0.4437033813587187,34314
213,43620,8150,1,1,0.9557590876649666,0.6973947988736352,0.8843846288462006,35470
214,8512,17737,1,1,0.7639719250972019,0.6120076396660371,0.791993188254413,-9225
215,21446,13592,0,0,0.6689118503410398,0.6027377786561781,0.4238832096657393,7854
216,27912,14861,1,1,0.7561203599054465,0.7199026928699614,0.8253410175918026,13051
217,40031,10755,1,1,0.5473238475042774,0.6174322190966182,0.7215853555336319,29276
218,41515,1711,1,1,0.7662113298978158,0.9073206992270012,0.8911773430416057,39804
219,21416,14706,0,0,0.8520967139312996,0.878209281437659,0.5767686651229862,6710
220,13280,11924,0,0,0.7664242355626486,0.8772742440913058,0.5478994932179848,1356
221,16974,14073,1,1,0.7415860445311033,0.6257634706764547,0.789116505069186,2901
222,49746,16921,1,1,0.8227568116112033,0.5556251747621016,0.7927939954577683,32825
223,49775,18813,1,1,0.8304024846949553,0.7123044894082173,0.8475689913677241,30962
224,42531,7444,0,0,0.6040094437494817,0.6774477450570598,0.4271523962688472,35087
225,18227,11684,1,1,0.7788822962278789,0.6086765256364952,0.7958529406214581,6543
226,19031,4420,1,1,1.0,0.5236398329999558,0.841213277666652,14611
227,49283,3068,1,1,0.6364983754351976,0.6937723046097892,0.776756893348329,46215
228,39000,8159,1,1,0.7614581167166934,0.639389582462129,0.8002825663929407,30841
229,8028,5806,0,0,0.9641746122051704,0.8032520555557029,0.5891422225869577,2222
230,36433,7844,1,1,0.8804175156543675,0.7997659077282219,0.8933944744608632,28589
231,24313,12683,1,1,0.7186603319223939,0.8651199708134075,0.8612601009119337,11630
232,15650,3906,1,1,0.7906135379622604,0.5111056672179942,0.7672397350600849,11744
233,32224,12117,1,1,0.7697888320015177,0.7601587461540449,0.8433158593851875,20107
234,36364,4665,1,1,0.6951928195678333,0.5908801440649492,0.7620243212109274,31699
235,24361,12622,1,1,0.7625747892506918,0.5169378683783372,0.7598375525430097,11739
236,8413,10348,1,1,0.7420033867193471,0.6357096644576934,0.7925710170590134,-1935
237,46794,16498,1,1,0.781274893807675,0.8603057470201926,0.8805268802759558,30296
238,37070,8882,1,1,0.6951616819308967,0.6441522469644273,0.7797713096317747,28188
239,44186,6289,1,1,0.6423381799755339,0.9348181989938668,0.8590521263231335,37897
240,28409,14910,1,1,0.765871922660763,0.78233177732805,0.8494012333296044,13499
241,35854,8798,1,1,0.941511821817878,0.6408864281529134,0.8607994166569304,27056
242,37206,4408,0,0,0.7782202926262797,0.8740072643359612,0.5507425189874137,32798
243,35655,18545,1,1,0.7368406221068455,0.7668095158171429,0.8345500459746628,17110
244,15952,18643,1,1,0.8454085805038498,0.5601160917329941,0.8018415574122812,-2691
245,42365,14959,1,1,0.7541680387404621,0.9788203953370772,0.9109961446925132,27406
246,23762,5090,1,1,0.956803292495911,0.7389218234629714,0.8985750386529608,18672
247,6620,12033,1,1,0.7696087490704921,0.7028194287978238,0.8241427259561053,-5413
248,39697,16362,1,1,0.8400497063158163,0.5716700995141576,0.8039066019433246,23335
249,21455,14783,0,0,0.6945395617606727,0.8769307401411607,0.5238234339672778,6672
250,28210,12394,1,1,0.8203089253336663,0.7775913141041959,0.8659667464792875,15816
251,6974,3981,0,0,0.7975093476943754,0.7943857270442861,0.5306316915795538,2993
252,18679,9065,1,1,0.7643493875340792,0.6238702984711347,0.7960732286684046,9614
253,33429,4554,0,0,0.719824223883028,0.8251150857865102,0.5149797698898461,28875
254,24073,13579,0,0,0.7061969834347626,0.8367720390356201,0.5143230074901276,10494
255,10671,19773,1,1,0.7982352663979653,0.5996832641828316,0.7993061768602656,-9102
256,36365,9158,1,1,0.8328939109696474,0.4874514790478513,0.7734484633391663,27207
257,14917,2014,1,1,0.7572837203705869,0.7872059589008386,0.8481632264238085,12903
258,47121,14527,0,0,0.7987267929120793,0.463997957559139,0.4209082501570727,32594
259,13784,13872,1,1,0.766208532186723,0.7228023666756669,0.8296702996207966,-88
260,39426,15201,1,1,0.7798526024905388,0.6329132342819039,0.8042552789241476,24225
261,41665,11218,1,1,0.7499555017322775,0.8827997816183382,0.8775850944502052,30447
262,18291,4713,1,1,0.7717972579368308,0.6410734163849189,0.8042902247739167,13578
263,24926,18876,1,1,1.0,0.8660909458005706,0.9553636486001902,6050
264,32154,8585,1,1,0.8011634298807425,0.6228685833455461,0.8080106710754295,23569
265,31650,5122,1,1,0.8345296958431043,0.8499986507589417,0.894842782200682,26528
266,9205,10892,1,1,0.8138023605328097,1.0,0.9379341201776032,-1687
267,42812,17838,1,1,0.7437183176702941,0.5397929292450638,0.7611704156384526,24974
268,36294,18301,1,1,0.8993989213291669,0.7438053582596361,0.8810680931962677,17993
269,42201,5374,1,1,0.7408836229573659,1.0,0.913627874319122,36827
270,45479,1489,1,1,0.8755054548942551,0.7099883240354382,0.861831259643231,43990
271,13384,1984,1,1,0.7365793001933552,0.7092682405344471,0.8152825135759341,11400
272,23261,18344,0,0,0.6740027480855959,0.8182748421026529,0.4974258633960829,4917
273,9059,2782,1,1,0.8065396208236193,0.7061621296142131,0.8375672501459442,6277
274,37734,15959,1,1,0.6595331643897894,0.443916100814417,0.7011497550680689,21775
275,29391,15542,1,1,0.8235640225016609,0.8698431062258407,0.8978023762425006,13849
276,21915,6983,1,1,0.6505841343908684,0.399557737920221,0.6833806241036965,14932
277,46281,2869,1,1,0.7380991969527146,0.6374812523292487,0.7918601497606544,43412
278,40442,12496,1,1,0.6268270303475258,0.8811138623734972,0.8359802975736743,27946
279,48568,7838,1,1,1.0,0.6465186357035821,0.8821728785678608,40730
280,31793,14550,1,1,0.6046040440383685,0.5959455261303394,0.7335165233895693,17243
281,37989,6702,1,1,0.7709813740396404,0.8318895857749841,0.8676236532715415,31287
282,31305,14027,0,0,0.8843304274330014,0.5723327819748419,0.4855544031359478,17278
283,22767,12860,1,1,0.8736385908587025,0.5166661420612069,0.7967682443066364,9907
284,44652,7032,0,0,0.8551342122173138,0.7411770981239925,0.5321037701137687,37620
285,24196,2825,1,1,0.7382771611778525,0.6725615052381113,0.8036128888053212,21371
286,24708,12554,1,1,0.9051088946337004,0.5134490328716736,0.8061859758351245,12154
287,19383,16333,1,1,0.8613391090802183,0.7955428809992304,0.885627330026483,3050
288,11248,13470,0,0,0.7912299617660477,0.769673140836585,0.5203010342008776,-2222
289,42197,4770,1,1,0.7940580757726592,0.6460367475091552,0.8133649410939382,37427
290,32440,1029,1,1,0.7396077352384628,0.656300199081258,0.7986359781065736,31411
291,27230,9958,0,0,0.6790347974166961,0.7705589113013734,0.4831979029060232,17272
292,35654,16502,1,1,0.8937150975478717,0.8785542129628099,0.9240897701702272,19152
293,22611,9806,1,1,0.9012207993601532,0.6575810184836013,0.8529339392812515,12805
294,28457,10196,1,1,0.6815890858970078,0.7982032739512216,0.8265974532827433,18261
295,16256,3121,1,1,0.7546214834853808,0.7847800325626898,0.8464671720160236,13135
296,46971,4009,1,1,0.7556576783541071,0.8318960939063464,0.8625179240868178,42962
297,46533,8739,1,1,0.7667344096259691,0.7058963798115198,0.8242102631458296,37794
298,40290,5059,0,0,0.7764294878587582,0.5631511728900462,0.4465268869162681,35231
299,39459,12285,0,0,0.864686146164618,0.6306251270200045,0.4984370910615408,27174
300,34281,3910,1,1,0.6952782691513256,0.7514280198672472,0.815568763006191,30371
301,7739,15674,1,1,0.685365300848734,0.9727696567572388,0.8860449858686575,-7935
302,7525,19354,0,0,0.8936619742142975,0.6273970565205582,0.5070196769116185,-11829
303,22453,13161,1,1,0.7237355258118702,0.8207181165291098,0.8481512141136599,9292
304,12251,12116,1,1,0.6436964646422934,0.650791532398486,0.7648293323469265,135
305,49208,14051,1,1,0.721487005790013,0.7165703133829203,0.8126857730576446,35157
306,25507,18626,1,1,0.7369947264755999,0.9273095123895388,0.8881014129550463,6881
307,19860,18096,1,1,0.9254962727725764,0.8146438872130649,0.9133800533285472,1764
308,27108,14054,0,0,0.8624826212376737,0.5138051090888565,0.4587625767755101,13054
309,33906,15070,1,1,0.8847520616632243,0.6141287464282613,0.8329602693638285,18836
310,13649,10485,1,1,0.8519973642346786,0.8884332016662038,0.9134768553002942,3164
311,40055,15413,1,1,0.8646243671615315,0.7212817063942742,0.8619686911852685,24642
312,19193,12855,1,1,0.7011917873419682,0.5276739820576204,0.7429552564665295,6338
313,37022,7153,1,1,0.7501397844646516,0.5771571332539418,0.775765639239531,29869
314,37656,6587,0,0,0.6710084686976452,0.8055240284066757,0.4921774990347736,31069
315,47535,9827,0,0,0.7489511969462966,0.8491615421826445,0.5327042463763138,37708
316,21913,7861,1,1,0.8384104990934741,0.7026782952223262,0.8470295981052668,14052
317,21629,11804,1,1,0.7834583284812247,1.0,0.927819442827075,9825
318,36692,14979,1,1,0.9011480818960296,0.8236228545183457,0.9082569788047916,21713
319,10954,2297,1,1,0.6558584207772781,0.6634778395550649,0.7731120867774477,8657
320,39512,15745,1,1,0.820023835069824,0.5776440927850983,0.7992226426183073,23767
321,16719,1357,0,0,0.6451697198130681,0.5537673543041437,0.3996456913724039,15362
322,33649,17300,1,1,0.7794176469173643,0.7503131980720554,0.8432436149964732,16349
323,18402,15433,1,1,0.8440333422556479,0.626683443262989,0.8235722618395456,2969
324,43344,17624,1,1,0.7485497433175781,0.9510615630975136,0.8998704354716972,25720
325,15216,11796,1,1,0.8251126604086956,0.9199467704376788,0.9150198102821248,3420
326,37050,19210,1,1,0.6740267665167066,0.7949599821245841,0.8229955828804302,17840
327,36272,9115,1,1,0.6036310021803617,0.5231505740564656,0.7089271920789425,27157
328,11050,4860,1,1,0.8257029622487804,0.5991671691171392,0.8082900437886398,6190
329,8438,13443,1,1,0.9444010234075731,0.888351628861165,0.9442508840895796,-5005
330,49150,5447,1,1,0.6703955059830108,0.6155400700307346,0.7619785253379151,43703
331,47587,17521,1,1,0.8922194180106795,0.8683212600879286,0.9201802260328694,30066
332,22760,2967,1,1,0.7743423408816411,0.7711905884552142,0.8485109764456183,19793
333,18078,7579,1,1,0.6364308478306924,0.707757682721978,0.78139617685089,10499
334,22473,5849,1,1,0.6568494698647838,0.5945750780596838,0.7504748493081559,16624
335,49815,8167,1,1,0.771578477336065,0.6858634234712873,0.8191473002691175,41648
336,15257,8466,1,1,0.7295537712075897,0.7284471932312346,0.8193336548129414,6791
337,28450,13349,1,1,0.6387087023241761,0.8548808347451682,0.8311965123564481,15101
338,31634,3019,1,1,0.6005960718774594,0.5671396599049368,0.7225785772607987,28615
339,34648,7174,1,1,0.6853280672073494,0.6605774736210827,0.7819685136094773,27474
340,33176,16689,0,0,0.7893809008331119,0.7067234697898427,0.4987014568743181,16487
341,16296,8092,1,1,0.7693599247396862,0.7994017536529247,0.8562538927975369,8204
342,27959,18576,1,1,0.7198762042499922,0.5637303493715834,0.7612021845405251,9383
343,20570,11505,1,1,0.7901887194291483,0.5025145310669177,0.764234416832022,9065
344,41423,3355,1,1,0.8740026719862688,0.8010947727565074,0.891699148247592,38068
345,20727,19890,1,1,0.8094126510434148,0.4723076327579945,0.760573427933803,837
346,23899,1333,0,0,0.757869132861042,0.8927469572143252,0.5502053633584557,22566
347,41785,3562,1,1,0.8628072006660689,0.6766110853775638,0.8464727620145442,38223
348,46111,15776,1,1,0.6740149697783705,0.467870337658833,0.7139617691457345,30335
349,18339,2795,0,0,0.7475080460444649,0.6279369670894759,0.4584816710446469,15544
350,40341,16270,1,1,0.7498912064399632,0.7568685449603856,0.8355865838001163,24071
351,11597,1253,1,1,0.6463046741557155,0.6200948368667533,0.7554665036741562,10344
352,33112,4657,1,1,0.7280125837715642,0.7030044623236521,0.8103390153650721,28455
353,42694,10615,1,1,0.5625040319104697,0.8110117548557929,0.7911719289220875,32079
354,16244,4237,1,1,0.9612178047662954,0.669671449691857,0.876963084819384,12007
355,9796,4331,1,1,0.6762586211563687,0.55944134853008,0.7452333232288163,5465
356,47591,2027,1,1,0.9286114131421312,0.6551524003942238,0.8612546045121183,45564
357,16053,15199,0,0,0.7738084505719492,0.912226020468889,0.5620114903469461,854
358,34528,19550,0,0,0.8264864132155959,0.9527596517999776,0.5930820216718579,14978
359,24648,14283,1,1,0.7211200201649068,0.3970110739086587,0.7060436980245218,10365
360,24431,13186,0,0,0.7907929691961675,0.8636541863787215,0.5514823851916296,11245
361,6535,17853,1,1,0.8350489639988437,0.7375221574053034,0.8575237071347157,-11318
362,46652,14781,1,1,0.8364552414394182,0.8385974018680225,0.8916842144358136,31871
363,12881,16120,0,0,0.8474773390074357,0.6174267609598555,0.4883013666557637,-3239
364,25481,6983,1,1,0.7331667289960824,0.434760473574777,0.7226424008569531,18498
365,48235,2093,0,0,0.7219640327508645,0.7876733182971192,0.5032124503493279,46142
366,41841,5789,1,1,0.6105823674732397,0.5588534108075924,0.7231452594269441,36052
367,7025,3912,1,1,0.8223219011176937,0.4917561352772721,0.7713593454649885,3113
368,36869,16111,1,1,0.8782378711323443,0.50223979262898,0.7934925545871082,20758
369,40819,15332,0,0,0.931598167991793,0.7901370673623002,0.573911745118031,25487
370,36192,17564,1,1,0.8005172634580507,0.7209178699043796,0.8404783777874768,18628
371,9621,13259,0,0,0.6933520227091431,0.817369903281201,0.5035739753301147,-3638
372,36566,10412,1,1,0.6002903856710544,0.8003612881744546,0.8002172246151696,26154
373,26947,17006,1,1,0.8741666733083351,0.636859965312435,0.8370088795402567,9941
374,20405,10755,1,1,0.5903723433222464,0.6894289639183816,0.7599337690802094,9650
375,10403,5684,1,1,0.7359395922256233,0.623284370682619,0.7864079876360807,4719
376,42091,8854,1,1,0.7475693172056355,0.6684508340701764,0.8053400504252707,33237
377,28525,7417,0,0,0.7630544862148981,0.5549117893028401,0.439322091839246,21108
378,11017,18946,1,1,0.773580260003584,0.7585726440811502,0.8440509680282448,-7929
379,45203,14127,1,1,0.7838147556367575,0.8612681123472634,0.881694289328007,31076
380,25729,18797,0,0,0.5284636737921471,0.577508045526852,0.3686572397729997,6932
381,34430,11698,1,1,0.7714655909870127,0.8921904468102013,0.8878853459324046,22732
382,44584,18401,1,1,0.5470424425888123,0.7170282244716912,0.7546902223535011,26183
383,43372,16428,1,1,0.8432218073090995,0.7361618464608719,0.8597945512566572,26944
384,42192,4654,1,1,0.7144874844196388,0.4450855720588722,0.7198576854928369,37538
385,20628,15997,1,1,0.554296327477665,0.4289106535651398,0.661068993680935,4631
386,18501,14742,1,1,0.6885795322614624,0.7216174544169522,0.8033989955594715,3759
387,36131,9949,1,1,0.7129924660815347,0.8184598186948011,0.8438174282587786,26182
388,29566,12971,1,1,0.8890699617555005,0.5992929334532571,0.8294542984029191,16595
389,29824,16391,1,1,0.7896637741750245,0.9505140850874634,0.9133926197541626,13433
390,8812,17565,1,1,0.804444494435058,0.8102403961381472,0.8715616301910684,-8753
391,38812,7829,1,1,0.8881221634220602,0.5637488122438021,0.8172903252219541,30983
392,33326,11487,1,1,0.7603855712075511,0.704627300058026,0.8216709570885258,21839
393,15402,3667,1,1,0.8454187961032403,1.0,0.9484729320344134,11735
394,32325,10991,1,1,0.8383861113931992,0.5136153995800441,0.7840005036577478,21334
395,47553,17287,1,1,0.6413530506430588,0.7792404908372658,0.8068645138267748,30266
396,32000,7173,1,1,0.917298357762983,0.6515883170914986,0.8562955582848272,24827
397,30259,10691,0,0,0.6279698219929306,0.8060344436377768,0.4780014218769025,19568
398,7926,16208,1,1,0.8617366649477849,0.8900910469477572,0.9172759039651808,-8282
399,6856,14235,1,1,0.6182926963094367,0.6420644366932948,0.7534523776675771,-7379
400,11988,14663,1,1,0.8301236788151674,0.867836840756076,0.8993201731904145,-2675
401,14743,10176,1,1,0.9561914878150172,1.0,0.9853971626050058,4567
402,10138,19748,1,1,0.7487021343449789,0.7099412106016352,0.8195477816488713,-9610
403,49848,16072,1,1,0.7443644357146854,0.8177333031241277,0.8540325796129377,33776
404,22082,6516,1,1,0.831043999931685,0.6114338844695087,0.814159294800398,15566
405,39374,19599,1,1,0.7370603544037457,0.7028888963546818,0.8133164169194759,19775
406,14863,17509,1,1,0.9518278703742822,0.6734987360937635,0.8751088688226819,-2646
407,43790,3620,0,0,0.7892192249458696,0.8195403888487893,0.5362532045982197,40170
408,35807,18835,1,1,0.7379830491779275,0.8807013903635388,0.8728948131804888,16972
409,28118,10200,1,1,0.7159714472104317,0.6835517726323811,0.7998410732809376,17918
410,11149,12896,1,1,0.676705152982698,0.9300434268599383,0.8689161932808789,-1747
411,44079,1696,1,1,0.7072245013242511,0.9295071162342444,0.878910539186165,42383
412,8484,3270,1,1,0.7349326606341404,0.827028061476985,0.8539869073703752,5214
413,31191,10226,1,1,0.721236092650142,0.6225960202417407,0.7812773709639608,20965
414,49809,17060,1,1,0.7041824725862896,0.6082256774890146,0.770802716691768,32749
415,26791,10727,1,1,0.979884123035244,0.5781427967964942,0.8526756399439127,16064
416,9807,10005,1,1,0.666990492351051,0.8423749105357241,0.8364551342955918,-198
417,32648,16084,1,1,0.7846632587646175,0.5182347688765954,0.7676326758804043,16564
418,37090,15816,1,1,0.8292521009760873,0.8015256481166511,0.8769259163642461,21274
419,31100,7717,1,1,0.8330107995583733,0.5378335978263831,0.7902814657949188,23383
420,36949,19428,1,1,0.7641392924217528,0.823531917976296,0.8625570701326829,17521
421,41941,2116,1,1,0.745929742815269,0.702582937409584,0.8161708934082844,39825
422,23857,18540,1,1,0.8151547491239507,0.9000457842789741,0.9050668444676416,5317
423,33850,16179,1,1,0.7966521649978201,0.8712181867481906,0.8892901172486702,17671
424,48967,1988,1,1,0.7441041165232487,0.9152598118003168,0.8864546427745218,46979
425,8412,11658,1,1,0.6138121428275569,0.9191228077433669,0.844311650190308,-3246
426,9182,6587,1,1,0.7232076277666752,0.7215446250982296,0.8149174176216349,2595
427,26948,19212,1,1,0.6553449836292542,0.5261810400363093,0.7271753412218546,7736
428,39782,16803,1,1,0.7032840449933674,0.5421215417503932,0.7484685289145868,22979
429,23253,17271,1,1,0.773322323851696,0.3869727206026093,0.720098348151435,5982
430,45681,11269,1,1,0.8058736143996617,0.5374501249857859,0.7811079131284826,34412
431,41495,7088,0,0,0.9480452751292406,0.7103235486556974,0.5527896079283127,34407
432,8852,3345,1,1,0.7162593621096186,0.6160518728762256,0.7774370783286148,5507
433,47845,10276,1,1,0.847462563527515,0.6729796593385222,0.8401474076220125,37569
434,24992,11543,1,1,0.8005960024437837,0.7739073129192101,0.8581677717876647,13449
435,7273,4005,0,0,0.899599767063979,0.6543902112901363,0.5179966594513717,3268
436,13649,5435,0,0,0.8276228719595626,0.5317256799381123,0.4531161839658916,8214
437,35002,17220,1,1,0.6691518572713684,0.6920149498654852,0.7870556023789512,17782
438,40723,11687,0,0,0.5976953970708769,0.5652264269840732,0.3876406080183167,29036
439,14778,15147,1,1,0.8011261699667505,0.6593820254531405,0.820169398473297,-369
440,30776,14613,1,1,0.717154900209961,0.9014165446634504,0.8728571482911373,16163
441,10549,16216,1,1,0.6719686254049403,0.6594242043855738,0.7771309432635047,-5667
442,21863,7628,0,0,0.6432422295466922,0.9656436330021616,0.5362952875162846,14235
443,17809,1076,1,1,0.7860975497587156,0.9147453980406954,0.9002809825998037,16733
444,14302,6752,1,1,0.9207707699313366,0.6131042037131434,0.8446249912148267,7550
445,14100,19946,1,1,0.7291327654293959,0.5333314350376336,0.7541547334890097,-5846
446,8911,18956,1,1,0.8290270311075323,0.6921168757119709,0.8403813022731678,-10045
447,18091,15994,1,1,0.7597733649782408,0.8729991645095333,0.8775908431625914,2097
448,15099,6970,0,0,0.6410617910896608,0.6264713640656967,0.4225110517184525,8129
449,11663,8952,1,1,0.8434811343510418,0.8362135447393209,0.8932315596967876,2711
450,35904,12862,1,1,0.6605307955972629,0.8812659983704132,0.8472655979892254,23042
451,34291,4111,1,1,0.7721626630593564,0.5838961524456091,0.7853529385016552,30180
452,47066,3737,1,1,0.7358479584994695,0.5985923367567119,0.7781467650853937,43329
453,42104,10544,1,1,0.8593077434565692,0.8068993048190509,0.88873568275854,31560
454,45137,5649,1,1,0.6641849007529314,0.7227771324462355,0.795654011066389,39488
455,8534,4868,1,1,0.809086990780196,0.5970907710184481,0.8020592539328814,3666
456,8226,8824,1,1,0.6860202592651299,0.6471729327820619,0.7777310640157307,-598
457,15585,8799,1,1,0.7188894787671215,0.689422067090887,0.8027705152860029,6786
458,33260,13379,1,1,0.4064799772459898,0.4652718362566809,0.6239172711675569,19881
459,33411,18386,1,1,0.9792098571617908,0.8148464659724042,0.9313521077113984,15025
460,38934,9614,1,1,0.8250556932826232,0.6281961716591213,0.8177506216472482,29320
461,16902,12101,1,1,0.6932652514061836,0.2824425664302851,0.6585692726121563,4801
462,42392,8906,0,0,0.6575344311667006,0.6964193547535821,0.4513179286400943,33486
463,24731,6359,1,1,0.7204351247120659,0.5887643111659738,0.76973314529268,18372
464,23788,10615,1,1,0.8416879534819451,0.9533233288454016,0.931670427442449,13173
465,37126,19017,1,1,0.5807915074415074,0.6121832468620048,0.7309915847678375,18109
466,48485,2753,0,0,0.7558415580705662,0.5353534954632083,0.4303983511779248,45732
467,8774,14481,1,1,0.9470641872462674,0.7761899004943024,0.90775136258019,-5707
468,15017,15130,1,1,0.6566053664032196,0.6009328947988625,0.7525127537340274,-113
469,31700,12114,1,1,0.7780385038763655,0.5830815698121651,0.7870400245628435,19586
470,31144,11495,1,1,0.9903309815257758,0.7764252074236608,0.9222520629831455,19649
471,35910,1146,1,1,0.8332151629690773,0.543929903816565,0.7923816889285474,34764
472,48918,8507,1,1,0.7825923820485455,0.481408951270082,0.7546671111062091,40411
473,42507,17700,1,1,0.8206636454909003,0.9588997003141504,0.9265211152683502,24807
474,32685,16977,1,1,0.7299134664990298,0.7869248106400967,0.8389460923797089,15708
475,30402,9797,1,1,0.899963128530344,0.6603686072508452,0.8534439119270631,20605
476,43232,9766,1,1,0.7300669977099788,0.6994784185447096,0.8098484720848962,33466
477,36063,2177,0,0,0.5740818391264023,0.7758796537174234,0.4499871642812752,33886
478,30125,12518,1,1,0.730869689605954,0.846000617442013,0.858956769015989,17607
479,30020,4422,1,1,0.6733265470123296,0.5866037063027482,0.7533100844383592,25598
480,37703,3594,0,0,0.7418805987802571,0.7549219788948524,0.4989341925583698,34109
481,37769,12074,1,1,0.7440915940919369,0.6239943735684642,0.7893619892201338,25695
482,19746,18148,1,1,0.8897423199804908,0.6716528133231063,0.8537983777678657,1598
483,10094,12392,1,1,0.8395292726664386,0.7241039301197356,0.8545444009287246,-2298
484,8930,1435,0,0,0.7963265487575397,0.6989982140420992,0.4984415875998796,7495
485,39531,4351,1,1,0.7697054588667405,0.8103350347453857,0.8600134978707087,35180
486,36755,12169,1,1,0.6641141991142006,0.7730629838673391,0.8123923943271798,24586
487,36105,17518,0,0,0.5518824762334322,0.4737746185941733,0.3418856982758685,18587
488,17552,9995,0,0,0.7813160011392783,0.4963265189401836,0.4258808400264873,7557
489,42218,3366,1,1,0.8494641203573658,0.644542497286106,0.8313355392144907,38852
490,25779,13367,0,0,0.7591666116755411,0.9742937893662738,0.5778201336806049,12412
491,35000,12454,0,0,0.71651456772133,0.5722612251247596,0.4295919309486966,22546
492,26103,10668,1,1,0.8164502165214212,0.668766593558087,0.828405603359836,15435
493,20102,4415,1,1,0.7616667799375653,0.6195480959565217,0.7937382919646957,15687
494,7861,11232,0,0,0.938574419197396,0.616893342386788,0.5184892538613947,-3371
495,49574,18390,1,1,0.8932728342068285,0.7267359615857583,0.8733362652641956,31184
496,38682,5691,1,1,0.865950805702333,0.9101165914293476,0.9253557990438936,32991
497,19283,8669,0,0,0.8457734114209904,0.7683952599820884,0.5380562238010262,10614
498,31597,19280,1,1,0.6409832585548543,0.5794703557859361,0.7401512047802634,12317
499,18436,3748,0,0,0.83629937020526,1.0,0.6120997900684201,14688
500,34424,3661,0,0,0.8076325957646575,0.7117859831441689,0.5064728596362754,30763
501,14890,16173,1,1,0.8306424728391164,0.613416856542683,0.8146864431272665,-1283
502,44297,12599,1,1,0.8192609486813053,0.9118144562016384,0.9103584682943144,31698
503,14299,7107,0,0,0.8152762587848066,0.6296394073084272,0.4816385553644113,7192
504,47348,13698,1,1,1.0,0.9494370482481164,0.983145682749372,33650
505,47384,14309,1,1,0.7623814330048081,0.569403581355,0.7772616714532693,33075
506,17157,3661,1,1,0.8636337380829331,0.9145045583382052,0.926046098807046,13496
507,35763,16133,1,1,0.7229010189735997,0.7301571496422541,0.8176860562052847,19630
508,38687,9210,1,1,0.8490641583887673,0.893657834905365,0.9142406644313774,29477
509,16191,4358,1,1,0.8639319890232455,0.9852648563052316,0.949732281776159,11833
510,17767,1275,1,1,0.8064426077135348,0.5301089064218119,0.7788505047117823,16492
511,23911,5078,1,1,0.93692469423765,0.8913657731137483,0.9427634891171328,18833
512,34629,12137,1,1,0.6815723963639583,0.4886644143361892,0.7234122702333825,22492
513,40794,5698,0,0,0.7212779058331777,0.5429223467127657,0.4214000841819811,35096
514,32944,1364,1,1,0.7912380086023489,0.5794885810311344,0.7902421965444945,31580
515,49726,11165,1,1,0.8580806853484222,0.7755454954266792,0.8778753935917004,38561
516,40623,1794,1,1,0.7879429521294934,0.7049523815402289,0.8309651112232408,38829
517,23981,14646,1,1,0.8985759036510567,0.6749295873755745,0.8578351636755438,9335
518,11958,6870,1,1,0.703831012903368,0.7219352918533541,0.8085887682522408,5088
519,20705,1589,1,1,0.6559421510511445,0.7886934383940208,0.8148785298150552,19116
520,36636,5313,1,1,0.8008128336536505,0.8002372185912029,0.8670166840816179,31323
521,48876,17211,1,1,0.7622819723886304,0.8641250253422696,0.8754689992436333,31665
522,31152,8377,1,1,0.824286372035822,0.9730052219151158,0.9324305313169792,22775
523,44529,9861,1,1,0.7672597709133496,0.6967956441337784,0.8213518050157095,34668
524,6688,18821,1,1,0.7359980209376543,0.6218366556803625,0.7859448922060056,-12133
525,31365,13952,1,1,0.7625062428276277,0.7920304193777782,0.8515122207351352,17413
526,35663,10047,1,1,0.7728848894793185,0.5283617775603069,0.7670822223465418,25616
527,45074,5033,1,1,0.739501870015167,0.5981943801832582,0.7792320833994751,40041
528,43840,19277,1,1,0.7496867953676573,0.8499071419589184,0.8665313124421918,24563
529,23739,19226,1,1,0.729640666301309,0.6813807437773444,0.8036738033595512,4513
530,16909,17710,1,1,0.8556665119869407,0.5187711312462941,0.7914792144110784,-801
531,18713,19784,1,1,0.7894021004505799,0.4765295401952238,0.7553105468819346,-1071
532,18614,5278,0,0,0.9956752472168766,0.7073075019090711,0.5676609163753159,13336
533,48089,8500,1,1,0.7860704551278462,0.8712844805452015,0.8857849785576826,39589
534,38561,5015,1,1,0.7149142529671338,0.8692818666296779,0.8613987065322705,33546
535,26734,9242,1,1,1.0,0.7166320754339256,0.9055440251446418,17492
536,36709,8826,1,1,0.8113626377714336,1.0,0.9371208792571446,27883
537,28885,10201,1,1,0.8690124786892817,0.6842769451089306,0.851096474599404,18684
538,12086,16105,1,1,0.8292102983202492,0.6792148564903884,0.8361417182702126,-4019
539,18731,1153,1,1,0.8323011029297749,0.31488461353915,0.7157285721563084,17578
540,26592,9773,1,1,0.8235654051352475,0.6328955576258176,0.818820320920355,16819
541,19341,18171,0,0,0.6597915435223934,0.8278022552362742,0.4958645995862225,1170
542,45435,5886,1,1,0.8067529047561413,0.9345942005289556,0.9137823684283656,39549
543,18976,3267,1,1,0.6375138696149761,0.5754648049499073,0.7376595581882945,15709
544,23374,1970,1,1,0.7525637163587466,0.7693378493939572,0.8406338552509013,21404
545,18333,9839,0,0,0.6974382543436712,0.8570318548484931,0.5181567030640548,8494
546,11290,14813,1,1,0.8057470185848724,0.7016812229793848,0.8358094138547525,-3523
547,29586,18329,1,1,0.8034126247338235,0.3575079313709154,0.7203068520349131,11257
548,22340,15450,1,1,0.8181145890765187,0.7370934999361378,0.8517360296708855,6890
549,41655,6618,1,1,0.7987296572749087,0.814214593609134,0.8709814169613476,35037
550,20560,2495,1,1,0.7093174658213601,0.5578865657472312,0.7557346771895305,18065
551,29997,3047,1,1,0.743899651064832,0.6618768203688419,0.8019254904778913,26950
552,7340,10364,1,1,0.8620396161254485,0.5266755936806853,0.7962384032687112,-3024
553,32013,14091,1,1,0.87678566772944,0.314477867712947,0.7304211784807957,17922
554,38862,3886,1,1,0.6553216901373451,0.8540506617681485,0.8364574506351645,34976
555,28282,16161,1,1,0.6169072367487354,0.6994377199297223,0.7721149855594859,12121
556,25076,5158,1,1,0.6973110616795288,0.9396512495057474,0.8789874370617587,19918
557,46894,7733,1,1,0.8745207582032251,0.8285983287859265,0.9010396956630504,39161
558,25665,2657,1,1,0.8914884030183035,0.6468685357501827,0.8461189795894954,23008
559,16923,6043,1,1,0.6775288119598828,0.6875229009843387,0.788350570981407,10880
560,45821,7360,0,0,0.8007309353736338,0.7849266086155258,0.5285525146630532,38461
561,16935,17862,0,0,0.9534431333140088,0.8450325125133614,0.5994918819424567,-927
562,30041,10329,1,1,0.8115311477240335,0.7484005946113017,0.853310580778445,19712
563,18467,5043,1,1,0.9121503285233094,0.8658389717934226,0.9259964334389108,13424
564,17073,15242,1,1,0.8698726570083098,0.6554996894988292,0.8417907821690465,1831
565,13691,1597,1,1,0.678980129377209,0.550428467982147,0.7431361991197853,12094
566,30490,3324,1,1,0.7510018576502921,0.6902786119658304,0.8137601565387076,27166
567,21688,8299,1,1,0.7734754478291848,0.7307777336104275,0.8347510604798707,13389
568,38969,12231,1,1,0.780413338802134,0.519769690789107,0.7667276765304137,26738
569,19829,1569,0,0,0.8616328953438571,0.4994916873780066,0.4537081942406213,18260
570,9086,4328,0,0,0.8108684762275409,0.767107944471014,0.5259921402328517,4758
571,8590,17524,1,1,0.4763799056221885,0.6390464722944365,0.7051421259722083,-8934
572,45893,4280,1,1,0.6387159726907274,0.6751238641506997,0.771279945613809,41613
573,13860,4590,0,0,0.5512619085023958,0.6460461001448764,0.3991026695490907,9270
574,44176,19422,0,0,0.7875365240655334,0.9280901352644816,0.571875553110005,24754
575,7948,18458,1,1,0.7940487649467761,0.88926417405925,0.8944376463353421,-10510
576,42731,14570,0,0,0.7983224958610718,0.5143969464941247,0.4375731474517321,28161
577,39461,3225,1,1,0.6741071732285384,0.6200810180379329,0.7647293970888237,36236
578,32295,15878,1,1,0.8374144005119989,0.8275006401954389,0.888305013569146,16417
579,44131,10533,1,1,0.841626249646853,0.7902904355654863,0.8773055617374464,33598
580,17924,10881,1,1,0.6444850932794842,0.6937813056505321,0.7794221329766721,7043
581,44655,17747,1,1,0.6233961798551128,0.5293599692553647,0.7175853830368258,26908
582,16851,14366,1,1,0.7699868313773063,0.5976189930769681,0.7892019414847581,2485
583,13734,16515,1,1,0.949178227361336,0.6224848648680565,0.8572210307431307,-2781
584,48681,11832,1,1,0.9399742742198642,0.741549149667865,0.8938411412959097,36849
585,11293,3030,1,1,0.8263404360448052,0.9555590732045856,0.9272998364164636,8263
586,19820,7685,1,1,0.6970003328419924,0.5969679647817807,0.7646560992079244,12135
587,8291,7157,1,1,0.8586842659488585,0.546094712866714,0.8015929929385242,1134
588,18391,14668,1,1,0.7247575735190959,0.6837120284758085,0.8028232006649682,3723
589,41466,18001,1,1,0.693249296332619,0.8547608470771088,0.8493367144699092,23465
590,47970,19366,1,1,0.5556033168378006,0.4829675549858945,0.6795236239412317,28604
591,36796,1193,1,1,0.7802382198347653,0.918045122631242,0.8994277808220025,35603
592,39809,9164,0,0,0.7070132650862625,0.6741952956826496,0.4604028535896374,30645
593,23591,2119,1,1,0.7796430379528505,0.589851999652994,0.7898316792019481,21472
594,48640,14351,1,1,0.5400642303762939,0.4599716069856761,0.66667861245399,34289
595,42389,7540,1,1,0.7869826672583687,0.8059781160130941,0.8643202610904875,34849
596,9352,13394,1,1,0.5268878836028372,0.6743243207137697,0.733737401438869,-4042
597,24062,17910,1,1,0.8787940253268552,0.725605822413176,0.8681332825800104,6152
598,34172,15860,1,1,0.8221891234135085,0.5648782388482954,0.7956891207539346,18312
599,16937,6845,0,0,0.7421335228575412,0.6521355948623464,0.4647563725732959,10092
600,34121,8971,0,0,0.826271986008208,0.6270128130467892,0.4844282663516657,25150
601,20602,15153,1,1,0.6721925737336447,0.6849110341932688,0.7857012026423046,5449
602,47740,4526,1,1,0.7772375515614892,0.5995671510436283,0.7922682342017059,43214
603,29136,2634,1,1,0.8494774038460335,0.4698728558969167,0.7731167532476501,26502
604,6945,12201,1,1,0.460571075090861,1.0,0.8201903583636203,-5256
605,25812,1093,0,0,0.7252775640322476,0.4954893628993728,0.4069223089772069,24719
606,13973,8716,0,0,0.7677355869863626,0.7272188510413808,0.4983181460092478,5257
607,29552,15331,1,1,0.7503706382254234,0.4341958257363936,0.7281888213206057,14221
608,20118,17472,1,1,0.9157101826227404,0.4004428845073037,0.7720510223766813,2646
609,17290,15241,1,1,0.6576098875077115,0.71467397377784,0.7907612870951839,2049
610,31123,19934,1,1,0.7078840756554772,0.7261551381652455,0.8113464046069075,11189
611,22383,12006,1,1,0.5784130973691551,0.8892248486203576,0.8225459819965043,10377
612,16366,7357,0,0,0.9210286651273144,0.7599320261523558,0.5603202304265568,9009
613,7797,2445,1,1,0.74537098573912,0.6775283921881313,0.8076331259757504,5352
614,32456,7335,1,1,0.7261591111963293,0.5575599633902493,0.7612396915288594,25121
615,27427,19214,1,1,0.7647517317689286,0.9248518102350324,0.8965345140013202,8213
616,8257,17938,1,1,0.8336235828430324,0.8393276869075336,0.8909837565835219,-9681
617,8197,12956,1,1,0.8047363403516125,0.5130505783377363,0.7725956395631162,-4759
618,14222,19818,0,0,1.0,0.7056945592315953,0.5685648530771984,-5596
619,31187,7919,1,1,0.8153935888403775,0.7216078347289745,0.845667141189784,23268
620,20152,6593,1,1,0.7234754570830919,0.6481519515091496,0.7905424695307471,13559
621,26781,17586,1,1,0.7138643262476053,0.8157775728710192,0.8432139663728749,9195
622,41680,8153,0,0,0.7307241047583191,0.8247599707522265,0.5184946918368486,33527
623,17004,5542,1,1,0.6198163075370162,0.6714271453292341,0.7637478176220834,11462
624,47642,17192,1,1,0.7739864207491586,0.6578696131303512,0.8106186779598366,30450
625,31515,14403,0,0,0.8483468106208918,0.9248437694001296,0.5910635266736738,17112
626,21416,14065,0,0,0.7086636399376764,0.8399258338543355,0.516196491264004,7351
627,12152,10878,1,1,0.6892619943715889,0.7108540584862576,0.8000386842859487,1274
628,13172,1828,1,1,0.9215945146294234,0.4556186441379919,0.7924043862558051,11344
629,9185,8170,1,1,0.6273516843378835,0.7516000159457553,0.7929839000945463,1015
630,31352,19406,0,0,0.5632181623522698,0.8047125197376501,0.4559768940299733,11946
631,36743,10749,0,0,0.6547098056352617,0.286821755740244,0.3138438537918352,25994
632,37212,14216,1,1,0.6159567282875704,0.7377804172477038,0.7845790485117581,22996
633,32618,12049,1,1,0.8086226064104582,0.6374962019806396,0.815372936130366,20569
634,15161,7785,0,0,0.7339295499550427,0.6668718579805673,0.4669338026452033,7376
635,23467,9998,1,1,0.748031295497616,0.5638928570855019,0.7706413841943727,13469
636,27589,5655,0,0,0.8852934176974774,0.6777716064394537,0.5210216747123103,21934
637,43630,19458,1,1,0.7008665138837223,0.9087987364271995,0.8698884167703073,24172
638,9070,7918,0,0,0.8475089411745641,0.6330402251776726,0.4935163887840789,1152
639,14563,4436,0,0,0.9211322799203204,0.8448360338189775,0.5886561045797659,10127
640,31254,5872,1,1,0.724433750198634,0.5790503171680584,0.7678280224555641,25382
641,22585,1360,1,1,0.8437022855556314,0.8138134288984058,0.8858385714846791,21225
642,36297,12909,1,1,0.745818208747102,0.7002483783432927,0.8153555290301316,23388
643,20772,5599,0,0,0.8624098128840789,0.752803724318392,0.5384045124008237,15173
644,20455,11168,0,0,0.6128510812423726,0.7010729884146231,0.4379746898856653,9287
645,12299,7731,1,1,0.6054487754874653,0.7962437848661812,0.8005641867845489,4568
646,16188,3077,1,1,0.730873228509246,0.3148622323099362,0.6819118202730609,13111
647,30763,14750,1,1,0.681107519094023,0.4870262029813645,0.7227112406917958,16013
648,38517,19557,1,1,0.7183290890570115,0.7625620747012967,0.8269637212527693,18960
649,27555,5691,1,1,0.748047341755286,0.3934692469155646,0.7138388628902835,21864
650,35323,18773,0,0,0.8420013531836252,0.6204129466529186,0.4874714332788479,16550
651,23938,4514,1,1,0.7292339421434065,0.6918488738445024,0.807027605329303,19424
652,27983,3919,1,1,0.6876138689376914,0.5757789793580654,0.7544642827652522,24064
653,18874,17385,1,1,0.7348486623241102,0.5962657895959339,0.7770381506400147,1489
654,30805,19317,1,1,0.6930854720193382,0.7407373300230388,0.811274267347459,11488
655,38822,1393,1,1,0.6765994497937285,0.8513942433669713,0.8426645643869,37429
656,26750,14457,0,0,0.6086983186423031,0.5562325928117788,0.3883103038180273,12293
657,42799,1529,1,1,0.7769478116221079,0.6137412705718944,0.7968963607313341,41270
658,48083,13211,0,0,0.7131294293402947,0.5903108540009432,0.4344800944470792,34872
659,33946,7495,1,1,0.8666278739234672,0.3367930372184082,0.7344736370472917,26451
660,7552,7953,1,1,0.6252603907941059,0.7212567685476262,0.7821723864472441,-401
661,36049,2713,1,1,0.7157916444952122,0.8402076618742738,0.8519997687898287,33336
662,13795,1635,1,1,0.951290722065875,0.8524964810973823,0.9345957343877525,12160
663,11271,16193,1,1,0.6760390482902151,0.5693850435338892,0.7484746972747015,-4922
664,20665,15633,0,0,0.7463466747903876,0.5122452927219786,0.4195306558374554,5032
665,6115,10309,1,1,0.6484156017174632,0.7032408321387527,0.783885477952072,-4194
666,42381,16778,0,0,0.6351572487219019,0.8243910529849701,0.4865161005689573,25603
667,34994,8445,1,1,0.924731098308768,0.7232275672465576,0.8826528885184418,26549
668,33186,13415,1,1,0.7871039492637147,0.7433956953810641,0.8434998815482597,19771
669,36267,15281,1,1,0.7833678838237623,0.871274639160435,0.8848808409947324,20986
670,45140,7602,0,0,0.6003683764883778,0.5891295161153944,0.3964992975345907,37538
671,30935,1037,1,1,0.8058741388108304,0.6670044869990455,0.8242928752699585,29898
672,37748,10824,1,1,0.8857421945993826,0.9451908267641802,0.943644340454521,26924
673,30603,4775,1,1,0.884947706082853,0.670478331535356,0.8518086792060696,25828
674,9837,11555,0,0,0.8368333229606161,0.5098994551050142,0.4489109260218768,-1718
675,42301,6120,1,1,0.6570514422404596,0.5995965855624558,0.7522160092676384,36181
676,15610,15678,1,1,0.8013123417192992,0.5592730223168136,0.7868617880120375,-68
677,34615,18425,0,0,0.8367584960476608,0.7535743878551906,0.5301109613009505,16190
678,17108,5715,1,1,0.5905556414911098,0.5656079494616831,0.7187211969842643,11393
679,44599,2394,1,1,0.6578720408518215,0.7406551379291867,0.7995090595936695,42205
680,28347,3869,1,1,0.8588157321743441,0.5895902172189025,0.8161353164644156,24478
681,40062,4676,1,1,0.8576045776671929,0.3814932192402657,0.7463659323024863,35386
682,13550,4721,1,1,0.6151416966378608,0.7459929680472883,0.787044888228383,8829
683,34205,6690,1,1,0.8495021459269173,0.7222695522320333,0.8572572327196503,27515
684,24459,6818,0,0,0.7795303399153618,0.777663672356326,0.5190646707572293,17641
685,29750,1234,1,1,0.8481008954607152,0.5990519171252114,0.8157176041953088,28516
686,33729,4140,0,0,0.7065478676566059,0.5830683286960935,0.4298720654508998,29589
687,44585,9638,1,1,0.8345183496480902,0.7602200287722318,0.864912792806774,34947
688,24162,13897,1,1,0.8543828774485624,0.9278529358796472,0.92741193777607,10265
689,16690,18383,0,0,0.7348665064544289,0.7016752014259491,0.4788472359601259,-1693
690,35104,18718,0,0,0.7717752546173287,0.7636877644070716,0.5118210063414668,16386
691,22757,9325,1,1,0.7051478370495347,0.6517618473361438,0.7856365614618929,13432
692,20770,11624,1,1,0.935163894868588,0.4684554217189473,0.8012064388625117,9146
693,16457,7090,1,1,0.7579728060674235,0.8451144128731086,0.8676957396468441,9367
694,48802,12377,1,1,0.6777975674822818,0.8362621358629243,0.8380199011150687,36425
695,23957,18495,1,1,0.698417408612525,0.806616103776279,0.835011170796268,5462
696,35619,15870,1,1,0.7826770601142113,0.6727081842486372,0.8184617481209496,19749
697,26828,3103,1,1,0.8453331171778212,0.789558414960781,0.878297177379534,23725
698,23171,6125,1,1,0.6364173154849478,0.8340642696081746,0.8234938616977074,17046
699,40313,7590,1,1,0.9547660002942449,0.943023802743506,0.965929934345917,32723
700,19146,11212,1,1,0.8008675294055616,0.8482789156971162,0.8830488150342259,7934
701,20202,10600,1,1,0.8166455972969413,0.7095731837550457,0.842072927017329,9602
702,43142,3921,1,1,0.7602810456176564,0.5037620116863443,0.7546810191013336,39221
703,27831,5734,1,1,0.7719258967351126,0.7233487446507612,0.8317582137952911,22097
704,15849,17037,0,0,0.7551716862072597,0.7384866093773961,0.4978860985282186,-1188
705,26439,1836,1,1,0.8717795969035961,0.8063544662977455,0.8927113544004471,24603
706,22990,13094,1,1,0.7692071412546629,0.9030837788985138,0.8907636400510589,9896
707,19336,10028,0,0,0.846705021849271,0.685727423191483,0.5108108150135847,9308
708,41344,11749,1,1,0.7266152476647428,1.0,0.9088717492215808,29595
709,28953,16432,1,1,0.7895640528312315,0.4361069469939134,0.7418903332750483,12521
710,11051,12051,1,1,0.6896079655760579,0.7629012808692437,0.8175030821484338,-1000
711,16068,16586,1,1,0.8916528232549538,0.5802219411723958,0.8239582548091166,-518
712,22967,6312,1,1,0.6866252759280884,0.4139167000466795,0.700180658658256,16655
713,27773,4822,1,1,0.7375020555738674,0.6697338435551262,0.8024119663763312,22951
714,49769,12622,1,1,0.7385039587545256,0.4814240952368565,0.7399760179971274,37147
715,37014,17099,0,0,0.7346048612326231,0.6757858152950774,0.4701302255092335,19915
716,14847,18188,0,0,0.8422495769442937,0.7052153872141684,0.5158216547194874,-3341
717,10881,2075,1,1,0.7383342235263356,0.8677812114003923,0.8687051449755759,8806
718,47182,15063,1,1,0.9093924530541072,0.4738622297854094,0.7944182276131722,32119
719,13699,17383,1,1,0.6881524913869832,0.8362667748468658,0.8414730887446163,-3684
720,30180,10605,1,1,0.7869377469942707,0.714712067541969,0.83388327151208,19575
721,43891,5452,1,1,0.6924214010687401,0.8543273730414391,0.8489162580367263,38439
722,9550,19047,1,1,0.8120972782531467,0.6352373237453308,0.8157782006661591,-9497
723,28163,13298,1,1,0.768405027302323,0.5001633119854831,0.7561894464292687,14865
724,49402,13368,1,1,0.7544937955301522,0.51737510106762,0.7572896321992574,36034
725,35675,8428,1,1,0.8888474966503525,0.5062288819499325,0.7983587928667616,27247
726,38934,19437,1,1,0.7045658128944897,0.7716721229380983,0.8254126452775292,19497
727,32592,16817,1,1,0.8286515157618001,0.9215383033322048,0.9167299396980017,15775
728,47077,3420,1,1,0.6931040087325208,0.6152572710017169,0.7694537599114125,43657
729,29039,19912,1,1,0.7812685200160374,0.7943702947386675,0.8585462715849017,9127
730,48769,5317,1,1,0.6504424671776554,0.471483691279657,0.7073087194857708,43452
731,29726,9412,1,1,0.703748285369326,0.7270481873765948,0.8102654909153069,20314
732,40974,17321,1,1,0.7617856954427135,0.8002843924505689,0.8540233626310941,23653
733,40018,1227,1,1,0.9514649167323078,0.4827812837084697,0.8114154001469259,38791
734,10558,19721,1,1,0.7800803870459774,0.6694174796530218,0.8164992888996664,-9163
735,38174,12456,1,1,0.9354668315866708,0.8073875710728348,0.9142848008865018,25718
736,36405,1955,1,1,0.7920323291690918,0.2599344029155784,0.6839889106948901,34450
737,48631,18881,1,1,0.7312915755525061,0.9003179592552614,0.8772031782692559,29750
738,8151,10472,1,1,0.9239356522600694,0.7530519063836572,0.8923291862145755,-2321
739,43845,2978,1,1,0.8137017622073419,0.8075091471576014,0.8737369697883145,40867
740,21552,18913,1,1,0.7057278406117287,0.6380921081207853,0.7812733162441713,2639
741,41065,13675,1,1,0.8170571459400298,0.4415916277651966,0.7528829245684089,27390
742,47996,17128,0,0,0.740740525009239,0.7801094434475427,0.5069499894855939,30868
743,8614,16668,1,1,0.5710965803828705,0.6876114511875231,0.7529026771901313,-8054
744,40647,8445,0,0,0.8635973159265617,0.7048173183148481,0.5228048780804699,32202
745,6620,5284,1,1,0.879493405564193,0.863141047779843,0.914211484448012,1336
746,29082,18585,0,0,0.9537942029992276,0.8143095810793897,0.5893679280262057,10497
747,27891,8131,0,0,0.8122143692195263,0.9881856125634418,0.6001333272609893,19760
748,47030,11614,0,0,0.7451276575917467,0.7230781343310249,0.4894019306409238,35416
749,38314,1759,1,1,0.8534989427378586,0.5963181343313324,0.816605692356397,36555
750,29500,14684,1,1,0.8549820365318906,0.671737472963691,0.8422398364985272,14816
751,40693,10680,0,0,0.9338281183136422,0.7623495058807909,0.5653925413981443,30013
752,34018,5371,1,1,0.7655372376933558,0.8523784778489465,0.8726385718474341,28647
753,25567,13651,0,0,0.7534421027432405,0.4799449072841921,0.4111290033424775,11916
754,31978,2665,1,1,0.6984455580241473,0.7012806422768753,0.7999087334336742,29313
755,16553,7918,1,1,0.8237462086725202,0.9414312485557552,0.921725819076092,8635
756,15630,11194,1,1,0.6151738331769165,0.663968669349622,0.7597141675088461,4436
757,18003,12213,1,1,0.8476087372862565,0.8396517782303656,0.8957535051722075,5790
758,47444,16745,1,1,0.828783512186579,0.7739676290824007,0.8675837137563266,30699
759,26648,8636,1,1,0.8285070202458372,0.843379090978747,0.890628703741528,18012
760,37607,18749,1,1,0.783822523650184,0.5785359187600101,0.7874528141367314,18858
761,43666,8344,1,1,0.9232978247531084,0.5791897494901629,0.8341625247477572,35322
762,30821,4201,1,1,0.8571993465426864,0.7030407838183431,0.8534133767870098,26620
763,20601,5752,1,1,0.70929228086243,0.4701667319139532,0.7264863375921277,14849
764,12121,10575,1,1,0.7110820950302353,0.6595389090082513,0.7902070013461623,1546
765,44557,11327,1,1,0.6820326186585364,0.73793149862735,0.8066547057619621,33230
766,22310,16891,1,1,0.8251283332775587,0.9676953410424658,0.9309412247733416,5419
767,28098,14029,1,1,0.6699861078760043,0.7604077283904732,0.8101312787554925,14069
768,29531,7091,0,0,0.8783392143583353,0.7937842706309652,0.5573744949964335,22440
769,45253,18905,1,1,0.9022973308345544,0.8746713770575009,0.9256562359640184,26348
770,15980,16866,1,1,0.6820983731049549,0.5553013616657415,0.7457999115902321,-886
771,42393,8521,1,1,0.7514451465407146,0.6752376006443521,0.8088942490616889,33872
772,14951,16410,1,1,0.7716620981362414,1.0,0.9238873660454138,-1459
773,14117,19007,1,1,0.8583983160469668,0.6881316666423236,0.8488433275630968,-4890
774,31979,6820,1,1,0.9309343375609878,0.8674646123173311,0.9327996499594396,25159
775,14989,12453,0,0,0.6014507607131423,0.8445606815759661,0.4820038140963694,2536
776,22915,5696,1,1,0.7381819282473318,0.4782829428418466,0.7388216236963928,17219
777,35535,2867,1,1,0.7433983304439653,0.74657189155089,0.8299900739982852,32668
778,38124,16723,0,0,0.6299330145113452,0.7220121208307838,0.4506483784473763,21401
779,39366,12817,1,1,0.7214889980695939,0.7494938181760652,0.8236609387485531,26549
780,13428,1168,1,1,0.8127768944350612,0.5868831280313409,0.7998866741554673,12260
781,30881,11213,1,1,0.7421321097160443,0.5324620732131761,0.7581980609764067,19668
782,10904,16223,0,0,0.6155378831392586,0.6285984999968722,0.4147121277120436,-5319
783,41677,12452,1,1,1.0,0.6853307504373696,0.8951102501457898,29225
784,14922,9027,1,1,0.796617786520418,0.8777476671400474,0.8914551512201552,5895
785,37160,17291,1,1,0.7811694130106676,0.972596622958841,0.9179220119898364,19869
786,8025,11641,1,1,0.6602073636932954,0.9094896769334766,0.856565680208924,-3616
787,19220,1224,0,0,0.7960706161971276,0.8290277816172766,0.5416994659381348,17996
788,8766,9749,1,1,0.7535786215958505,0.5493489606550614,0.7676425274169706,-983
789,24482,7582,1,1,0.5811476587284594,0.6386655737515756,0.7399377441600117,16900
790,39159,2573,1,1,0.6629744559985584,0.7314889078619496,0.7981544546201693,36586
791,16935,9577,1,1,0.8494926017673945,0.6051341442885737,0.8182089153519895,7358
792,9784,9712,0,0,0.9644017650000442,0.7865808478791926,0.5836608709597456,72
793,29050,7763,0,0,0.8067165405043045,0.8080729162381431,0.5382631522474826,21287
794,26221,13164,1,1,0.8803083278293368,0.7804435093848202,0.8869172790713856,13057
795,35179,6217,1,1,0.754424469141679,0.8537701906836371,0.8693982199417721,28962
796,24069,17272,1,1,0.7613453839319397,0.5643113179430389,0.7752189006249929,6797
797,41682,13734,1,1,0.8790979027619465,0.8399243056138296,0.9063407361252588,27948
798,31994,12353,1,1,0.9362777289179468,0.5956531824819705,0.8439769704666391,19641
799,34767,4501,1,1,0.9001096693465622,0.5588596071035672,0.8196564254833764,30266
800,18282,14530,1,1,0.663363692461518,0.7798174201279572,0.8143937041964917,3752
801,26110,13394,1,1,0.7633041109684754,0.882381034329847,0.8818950484327742,12716
802,37232,2499,1,1,0.7977524684476296,0.7732020229564014,0.8569848304680102,34733
803,10951,10669,1,1,0.7440322036492472,0.7031206035658816,0.8157176024050429,282
804,13655,11519,1,1,0.8087857543415596,0.746523073915226,0.8517696094189287,2136
805,35461,14239,1,1,0.8520576811668947,0.7204640377100919,0.8575072396256621,21222
806,10610,19128,1,1,0.8702809751955141,0.5311073655796908,0.8004627802584016,-8518
807,37617,3039,1,1,0.9385870152221524,0.5136069782582626,0.817397997826805,34578
808,23468,9311,1,1,0.7370558895275166,0.6881761180789817,0.8084106692021661,14157
809,13583,4857,0,0,0.6335966835160686,0.7119785253653955,0.4485250696271547,8726
810,31583,5950,1,1,0.8058234594014453,0.7016998567551601,0.8358411053855351,25633
811,23701,16441,1,1,0.9583811031184802,0.8014152420474869,0.9199321150553224,7260
812,12880,13735,1,1,0.7223024140045942,0.667678492575349,0.7966603021933144,-855
813,41117,2743,1,1,0.838684697706372,0.7844468772857284,0.8743771916640335,38374
814,29721,14283,1,1,0.8395745792472643,0.6783119849010327,0.8392955213827656,15438
815,45976,10638,1,1,0.7891442047344609,0.97350384430547,0.9208826830133102,35338
816,32854,4616,1,1,0.7706924721043714,0.712107059008967,0.8275998437044462,28238
817,12881,16383,0,0,0.6776570794278608,1.0,0.5592190264759536,-3502
818,9722,4894,1,1,0.5418337927579423,0.7528017386636296,0.7648785104738574,4828
819,26077,19108,1,1,0.6588149293335971,0.6679484244117676,0.7755877845817882,6969
820,21332,7227,0,0,0.73096958508883,0.5650828035610488,0.4320174628832929,14105
821,45992,11464,1,1,0.8797422687422707,0.4835667138913459,0.7877696608778723,34528
822,19229,8847,1,1,0.7596871937648625,0.5512836573405764,0.7703236170351463,10382
823,13802,5281,0,0,0.7180974281081851,0.5680590536254015,0.4287188272445288,8521
824,28101,19584,1,1,0.680901455804657,0.7592230030618264,0.8133748196221612,8517
825,17439,3143,1,1,0.835680582850948,0.6210751943409718,0.8189185923973067,14296
826,41902,15780,1,1,0.9058357166430604,0.7280390578831746,0.8779582581754117,26122
827,8598,4181,1,1,0.876343572186746,0.8922967543565028,0.9228801088477496,4417
828,32761,7520,1,1,0.8306149699758469,0.6868287472547719,0.8391479057435397,25241
829,10052,14052,0,0,0.622438725361706,1.0,0.5408129084539021,-4000
830,18741,13271,1,1,0.7348325757156229,0.5236283529491202,0.7528203095549144,5470
831,9824,18480,1,1,0.9647304228889676,0.6774124677437607,0.8807142968775761,-8656
832,42288,13499,1,1,0.8821950491915225,0.6191030614583531,0.8337660368832919,28789
833,7249,9915,0,0,0.6162496781765275,0.8404759909085511,0.4855752230283595,-2666
834,28970,17122,1,1,0.7644409476800729,0.3640312554450818,0.7094907343750516,11848
835,21565,12431,1,1,0.8063098432661039,0.4835327066233282,0.7632808499631439,9134
836,24458,7918,0,0,0.693784153697378,0.6838979766323555,0.4592273767765778,16540
837,8014,9148,1,1,0.5390795978591152,0.932706658151424,0.8239287520035131,-1134
838,10944,14038,0,0,0.7798824045016431,0.733876275105596,0.5045862265357464,-3094
839,39716,14805,1,1,0.6912241742379561,0.4972678818603648,0.7294973520327735,24911
840,49451,8749,1,1,0.6916158260915316,0.5204250110964654,0.7373469457293323,40702
841,20012,3871,0,0,0.7345319640069242,0.9509484554267428,0.561826806477889,16141
842,43460,5489,1,1,0.7566324085345189,0.6068297801805639,0.7878207295716942,37971
843,9240,5607,0,0,0.7690917205904314,0.5585554941325354,0.4425490715743223,3633
844,48530,13973,1,1,0.6816010101077998,0.9216058840946292,0.8677356314008096,34557
845,19731,13111,1,1,0.7479790470365922,0.8516645508380486,0.8665478659582136,6620
846,24018,6834,1,1,0.5942576629597245,0.8911089464900194,0.828455536483248,17184
847,48898,10912,1,1,0.8011039065368079,0.5574937179601275,0.786199208165645,37986
848,23916,4399,0,0,0.4843724586658842,0.4712341538478458,0.3185355375045767,19517
849,46376,19241,1,1,0.741050991956638,0.7199749734044057,0.8203419884536812,27135
850,33604,8604,1,1,0.8619186153676953,0.7502689199610495,0.8707291784429149,25000
851,26030,11957,0,0,0.6640659312725173,0.7546902705557247,0.4729187339427473,14073
852,17589,8731,1,1,0.84164302036574,0.9217275903458502,0.9211235369038634,8858
853,27983,19780,1,1,0.8855732712120893,0.4399349364987627,0.7751694025702839,8203
854,18437,16808,1,1,0.4392100047502612,0.8289542576946648,0.7560547541483086,1629
855,33618,3261,0,0,0.7548637096424258,0.5355062433779023,0.4301233176734427,30357
856,15705,12809,1,1,0.4824226572371725,0.8283602981291261,0.7702609851220995,2896
857,28680,18696,1,1,0.7581791554429054,0.6287564943217934,0.795645216588233,9984
858,21376,11056,1,1,0.7692828789018673,0.5779042306164233,0.7823957031727634,10320
859,31420,19689,1,1,0.5217456014089161,0.6085145939576196,0.7100867317888452,11731
860,46358,1997,1,1,0.9624838362079866,0.4831584698835156,0.8152141020305007,44361
861,45333,16155,1,1,0.7986015807634625,0.70606434097502,0.8348886405794942,29178
862,7835,7353,1,1,0.6850976567917965,0.5840989914009314,0.7563988827309093,482
863,27283,19703,1,1,0.916537942749852,0.8179447346350417,0.9114942257949646,7580
864,48565,4207,1,1,0.5904386779357683,0.7960084121549376,0.7954823633635687,44358
865,41963,10275,1,1,0.6470828966481683,0.9532235579354186,0.866768818194529,31688
866,15179,16874,1,1,0.5400544476330101,0.7549491225311615,0.7650011900547239,-1695
867,34904,4086,1,1,0.9501045196539334,0.7781016650620111,0.9094020615719814,30818
868,47113,16973,1,1,0.8032346371472003,0.910014971774172,0.904416536307124,30140
869,39674,18105,1,1,0.8359401789848495,0.6058505955959955,0.813930258193615,21569
870,17955,15870,1,1,0.8001001233918476,0.476761268076545,0.7589537971561309,2085
871,13198,2154,1,1,0.8273767761144585,0.730014108869259,0.8524636283279059,11044
872,7620,17029,1,1,0.777807771389599,0.4866049796178393,0.7548042503358129,-9409
873,17766,8167,1,1,0.7970921342707441,1.0,0.9323640447569148,9599
874,37090,1016,0,0,0.7807603436222951,0.9183247438118414,0.5663616958113789,36074
875,47291,8097,1,1,0.7091408194430722,1.0,0.9030469398143574,39194
876,10338,14165,1,1,0.7653375234785331,0.7093670464994694,0.8249015233260009,-3827
877,11301,19616,1,1,0.7973594573261678,0.7825860390552396,0.8599818321271359,-8315
878,21144,12654,1,1,0.7810549119552131,0.6310786852071033,0.8040445323874389,8490
879,19784,18830,0,0,0.6222227892246683,0.8324387208380127,0.4848871700208937,954
880,8423,17205,1,1,0.635501333139159,0.5176685181923414,0.7177232837771669,-8782
881,14272,10657,1,1,0.8782841433916392,0.3185360215787831,0.7322733883234741,3615
882,7573,12959,1,1,0.7393005954116598,0.5813934070767149,0.773564667496125,-5386
883,30419,12819,1,1,0.828472534703594,0.4816789786574026,0.7700505044536655,17600
884,22803,4083,1,1,0.6607880090277604,0.9216890104239304,0.8608256731505636,18720
885,39234,10735,0,0,0.622685412335347,0.9723516182620472,0.5316790101991314,28499
886,11176,7952,0,0,0.6856403387468287,0.4895606391380333,0.391733659294954,3224
887,42161,15637,0,0,0.7477434929228587,0.8937573411281858,0.5471669446836814,26524
888,48525,10463,1,1,0.7034859700715588,0.8427077475251155,0.8487312391988914,38062
889,21164,6391,1,1,0.8993933523105714,0.4645334972921685,0.7879756165342466,14773
890,18222,15468,1,1,0.7879523301537462,0.6414598703602572,0.8098040668380012,2754
891,31379,16091,1,1,0.954893861856186,0.612975441681322,0.8559564345125027,15288
892,31653,15964,1,1,0.8104408154071417,0.81219930979408,0.8742133750670739,15689
893,24016,9964,1,1,0.5287449182080189,0.5156830973642479,0.6814760051907557,14052
894,24368,8914,1,1,0.8756041606458554,0.6851691061510776,0.8535910889323111,15454
895,29505,15476,1,1,0.6190448377530046,0.5971098244075572,0.7387182207201871,14029
896,38771,17866,0,0,0.7930533667211339,0.7710011775077714,0.5213515147429685,20905
897,46245,8437,1,1,0.6925315942336155,0.6674811952468106,0.7866709298268088,37808
898,44766,12371,1,1,0.9842711034464188,0.6197131444089407,0.8679947492851198,32395
899,39370,10773,1,1,0.9139597927430136,0.6680055136551882,0.8606551021327339,28597
900,13256,6203,1,1,0.6958179358298242,1.0,0.8986059786099414,7053
901,49327,16430,1,1,0.7572642331878888,0.6374650545820916,0.7982430959233268,32897
902,34251,13462,1,1,0.7944598069649218,0.5438492172574318,0.7794363414074512,20789
903,37977,10033,1,1,0.856341407156161,0.7875150353733947,0.8812854808431853,27944
904,38664,19256,1,1,0.7729151912325013,0.6784712995865565,0.8171288302730192,19408
905,12714,16754,1,1,0.6675105100619133,0.4877149103700291,0.7184084734773141,-4040
906,47144,4320,1,1,0.6982441360799947,1.0,0.8994147120266649,42824
907,17701,15979,1,1,0.7695518203623208,0.6471281581620028,0.8055599928414412,1722
908,20891,3728,0,0,0.8934456978764691,0.6433195819057973,0.5122550932607555,17163
909,42019,18338,1,1,0.8127837860536045,0.7239753027862146,0.8455863629466064,23681
910,33516,2595,1,1,0.6926585073384984,0.9595175153813258,0.8840586742399413,30921
911,46912,3288,1,1,0.834837277770979,0.4480382010221506,0.7609584929310431,43624
912,15916,7845,1,1,0.7313015161121841,0.7413978774130809,0.8242331311750885,8071
913,8910,8663,1,1,0.8590408005186841,1.0,0.9530136001728948,247
914,24254,18127,1,1,1.0,0.7193093021109472,0.9064364340369824,6127
915,42116,18878,0,0,0.7341173629056451,0.514699903104478,0.4162724220033744,23238
916,23985,7944,1,1,0.8501605159726371,0.607240472055902,0.8191336626761797,16041
917,28151,13302,1,1,0.6954606667962271,0.7310323794635185,0.8088310154199152,14849
918,11830,11180,0,0,0.7587736232808703,0.8996205873459793,0.5527980702089499,650
919,46888,1207,1,1,0.7729562286872101,0.6490996233375909,0.8073519506749337,45681
920,24474,2083,1,1,0.750631633995562,0.8239977696148647,0.8582098012034756,22391
921,11480,19796,1,1,1.0,0.4846946759429665,0.8282315586476555,-8316
922,15443,4311,1,1,0.7393406925321617,0.4834422445607418,0.7409276456976345,11132
923,45138,9588,1,1,0.8286851538784868,0.6275798966972576,0.8187550168585815,35550
924,38938,17592,0,0,0.5769913130676567,0.9157043082809893,0.4975652071162153,21346
925,8809,14444,1,1,0.813199656336961,0.7103311959270653,0.8411769507546755,-5635
926,45761,6850,1,1,0.8842054592352246,0.7434716793349928,0.8758923795234058,38911
927,32930,19820,1,1,0.7172402657420949,0.7417119393360291,0.8196507350260412,13110
928,29095,13719,1,1,0.5189777858959588,0.8663811973880096,0.795119661094656,15376
929,17946,17517,1,1,0.7661348231172675,0.6084668961193218,0.7915339064121966,429
930,9991,18022,1,1,0.7717183850385528,0.8032427662732348,0.8583203837705958,-8031
931,29519,2228,1,1,0.8424075050744304,0.5753676004217304,0.8059250351653869,27291
932,32657,5019,1,1,0.9710903035413434,0.997490898388114,0.9895270673098192,27638
933,6826,10482,1,1,0.7319946349399693,0.5799413343554964,0.7706453230984885,-3656
934,48625,15105,1,1,0.684371187633972,0.5676416045382069,0.7506709307240597,33520
935,22513,19580,1,1,0.6533082198628557,0.7824504720232074,0.811919563962021,2933
936,23801,10895,1,1,0.78980786170316,0.7119682647148485,0.8339253754726695,12906
937,35846,15135,0,0,0.8179354258818502,0.7490278609391401,0.5223210956069968,20711
938,45566,17245,1,1,0.7154344605637416,0.7340970693238477,0.8165105099625297,28321
939,29157,11387,1,1,0.847868274572579,0.5364411701788842,0.7947698149171544,17770
940,34363,18359,1,1,0.8165384076819175,0.9420038393619226,0.9195140823479466,16004
941,11136,15904,1,1,0.774323168964489,0.8340313308833663,0.8694514999492852,-4768
942,23421,7121,1,1,0.6797585279255874,0.9038424926900672,0.8612003402052183,16300
943,18491,2028,1,1,0.7218135684515277,0.6207503666334363,0.7808546450283212,16463
944,13546,17909,0,0,0.5270244702317455,0.7624785317072756,0.4298343339796737,-4363
945,11903,3327,1,1,0.7935787064198034,0.7296052693352036,0.841061325251669,8576
946,22406,19930,1,1,0.7726341288747436,0.8692003939302261,0.8806115076016566,2476
947,20949,18219,1,1,0.7888478991089487,0.8740372197744428,0.8876283729611304,2730
948,15825,3483,1,1,0.8204319015564561,0.7289576204437171,0.8497965073333912,12342
949,12287,3734,1,1,0.8085821486432223,0.4723073302235122,0.7602964929555781,8553
950,40173,10730,0,0,0.7589616819353965,0.9669492830631532,0.5753036549995166,29443
951,48438,11102,1,1,0.7748668043162753,0.7833981150535207,0.8527549731232652,37336
952,23578,8304,0,0,0.629568358330383,0.6087344437913287,0.4127676007072372,15274
953,47535,5049,1,1,0.7116279354310574,0.7609813207400042,0.8242030853903538,42486
954,13923,15947,1,1,0.7750471053683462,0.4733359677321214,0.7494610243668226,-2024
955,40374,10495,1,1,0.6964146424087639,0.8583029601206565,0.8515725341764734,29879
956,47411,1392,1,1,0.8560150795872546,0.479318238358127,0.7784444393151273,46019
957,14316,12776,1,1,0.704136791904497,0.6668748261944376,0.7903372060329782,1540
958,16556,11867,0,0,0.7916305411248317,0.7366681674408324,0.5094329028552214,4689
959,16058,3466,1,1,0.7816565656815336,0.855825956797314,0.8791608408262825,12592
960,45018,2225,0,0,0.844627759361041,0.715981701465156,0.5202031536087324,42793
961,40451,15987,1,1,0.8600791174028302,0.7952444310418825,0.885107849481571,24464
962,31482,1461,0,0,0.839403261096794,0.695774963732567,0.5117260749431204,30021
963,31005,10993,1,1,0.5593993798616866,0.6951721073583575,0.751523829073348,20012
964,25135,12465,1,1,0.8894148148013127,0.7128215875522446,0.8674121341178523,12670
965,29888,17535,1,1,0.9227308224194598,0.6716413118721438,0.8647907114305345,12353
966,38481,11461,0,0,0.7217875715678531,0.4470144635377846,0.3896006783685459,27020
967,34401,13366,1,1,0.793664691267285,0.5847514759455057,0.7928053890709302,21035
968,46431,2785,1,1,0.6809168319869219,0.7367162261667547,0.8058776860512255,43646
969,30937,7242,1,1,0.5751621493267849,0.6626318494766921,0.7459313329344924,23695
970,19146,15312,0,0,0.6961284734457613,0.676628637672714,0.4575857037061584,3834
971,36101,7356,1,1,0.7159860960536389,0.6514969495841927,0.7891610152126104,28745
972,17253,19220,1,1,0.7345149268648185,0.5704602410902273,0.7683250559850153,-1967
973,9223,10589,0,0,0.6741085909994012,0.6260350808535559,0.4333812239509857,-1366
974,11441,2493,1,1,0.6966574833182761,0.6539752383417108,0.7835442405533289,8948
975,48590,18932,1,1,0.7688993678371593,0.7007714710812774,0.8232236129728122,29658
976,46149,6163,1,1,0.6929773016889857,0.7590067516704568,0.8173280177864809,39986
977,18863,10612,0,0,0.8243524332550028,0.6729174563671391,0.4990899632073806,8251
978,43952,15297,0,0,0.838166065139744,0.545551711646137,0.461239258928627,28655
979,35564,6704,1,1,1.0,0.4902876940121825,0.8300958980040608,28860
980,22653,7688,1,1,0.8825679932123462,1.0,0.9608559977374488,14965
981,30088,16835,1,1,0.7943103058328415,0.5305277454603154,0.774946017097719,13253
982,28499,19447,1,1,0.7079735703332322,0.6222062498103426,0.7767266067145249,9052
983,48083,19404,1,1,0.7993747351673999,0.7775500453770903,0.8589749268481635,28679
984,29682,11341,0,0,0.8026595959916356,0.7541290914348521,0.5189295624754959,18341
985,38132,8353,0,0,0.718668691099434,0.7781298538842358,0.4989328483278899,29779
986,10533,10142,1,1,0.8483731396752878,0.6335924395701736,0.8273218597484872,391
987,23426,16266,1,1,0.6301901985318125,0.7357837105959321,0.7886579697092482,7160
988,20560,9216,1,1,0.7455600164462489,0.7092015496361295,0.8182538553607929,11344
989,40409,16932,1,1,0.8255858459317407,0.6531802948688069,0.8262553802668492,23477
990,21925,13017,0,0,0.7412415852407903,0.736811461265701,0.492684348835497,8908
991,28987,1569,1,1,0.7493245596570729,0.8583048320126059,0.8692097972232262,27418
992,16633,6112,1,1,0.756221413880772,0.6966699664847013,0.8176304601218244,10521
993,42065,2355,1,1,0.6864398759312255,0.6976679269534638,0.7947026009615631,39710
994,36125,9056,1,1,0.8873900931574208,0.8602241552313976,0.915871416129606,27069
995,9996,17086,0,0,0.6681962328077184,0.8442040539728219,0.5041334289268468,-7090
996,6014,18214,1,1,0.8018159327409885,0.9375904661445223,0.9131354662951704,-12200
997,20895,15220,1,1,0.8113647898282373,0.4365654648280634,0.7493100848854336,5675
998,7674,15498,1,1,0.6751378098791033,0.8357678774754084,0.8369685624515039,-7824
999,43867,1834,1,1,0.7773104254380744,0.7902370068103268,0.8558491440828004,42033
